Reporting_IsEditorial	boolean
Reporting_DistinctQueryInSession	int
Session_Duration	int
Query_IsAutoSuggest	boolean
Request_IsQuery	boolean
Request_ResponseFormat	string
Query_IsAdult	boolean
Request_IsTestingTraffic	boolean
Query_IsSpellSuggestionCorrection	boolean
Query_IsQueryAlteration	boolean
QueryDate	string
Metrics_NoResultsQueryViewCount	int
Metrics_BingDefaultsOldHomePage	string
Metrics_BingDefaultsNewHomePage	string
Metrics_DwellTime	double
Metrics_QueryViewCountWithCoreResultPresent	int
Metrics_ResultForceToBottomAnswerQuickBackClickCount	int
Metrics_ECardQuickBackClickCount	int
Metrics_NewsAnswerItemCount	int
Metrics_NewsAnswerClickCount	int
Metrics_QueryViewCountWithNewsAnswerPresent	int
Metrics_QueryViewCountWithNewsAnswerClicks	int
Metrics_NewsAnswerQuickBackClickCount	int
Metrics_PhonebookAnswerItemCount	int
Metrics_PhonebookAnswerClickCount	int
Metrics_QueryViewCountWithPhonebookAnswerPresent	int
Metrics_QueryViewCountWithPhonebookAnswerClicks	int
Metrics_PhonebookAnswerQuickBackClickCount	int
Metrics_VideoAnswerItemCount	int
Metrics_VideoAnswerClickCount	int
Metrics_QueryViewCountWithVideoAnswerPresent	int
Metrics_QueryViewCountWithVideoAnswerClicks	int
Metrics_VideoAnswerQuickBackClickCount	int
Metrics_ImageAnswerItemCount	int
Metrics_ImageAnswerClickCount	int
Metrics_QueryViewCountWithImageAnswerPresent	int
Metrics_QueryViewCountWithImageAnswerClicks	int
Metrics_ImageAnswerQuickBackClickCount	int
Metrics_CommerceAnswerItemCount	int
Metrics_CommerceAnswerClickCount	int
Metrics_QueryViewCountWithCommerceAnswerPresent	int
Metrics_QueryViewCountWithCommerceAnswerClicks	int
Metrics_CommerceAnswerQuickBackClickCount	int
Metrics_SongsAnswerItemCount	int
Metrics_SongsAnswerClickCount	int
Metrics_QueryViewCountWithSongsAnswerPresent	int
Metrics_QueryViewCountWithSongsAnswerClicks	int
Metrics_SongsAnswerQuickBackClickCount	int
Metrics_FinanceAnswerItemCount	int
Metrics_FinanceAnswerClickCount	int
Metrics_QueryViewCountWithFinanceAnswerPresent	int
Metrics_QueryViewCountWithFinanceAnswerClicks	int
Metrics_FinanceAnswerQuickBackClickCount	int
Metrics_WeatherAnswerItemCount	int
Metrics_WeatherAnswerClickCount	int
Metrics_QueryViewCountWithWeatherAnswerPresent	int
Metrics_QueryViewCountWithWeatherAnswerClicks	int
Metrics_WeatherAnswerQuickBackClickCount	int
Metrics_MapsAnswerItemCount	int
Metrics_MapsAnswerClickCount	int
Metrics_QueryViewCountWithMapsAnswerPresent	int
Metrics_QueryViewCountWithMapsAnswerClicks	int
Metrics_MapsAnswerQuickBackClickCount	int
Metrics_BlogAnswerItemCount	int
Metrics_BlogAnswerClickCount	int
Metrics_QueryViewCountWithBlogAnswerPresent	int
Metrics_QueryViewCountWithBlogAnswerClicks	int
Metrics_BlogAnswerQuickBackClickCount	int
ForayMetrics_HomepageOverall_PageViews	int
ForayMetrics_HomepageSearchBox_New_ClickCount	int
ForayMetrics_HomepageCore_ClickCount	int
ForayMetrics_HomepageImageViewer_ClickCount	int
ForayMetrics_HomepageSearchBox_New_ItemCount	int
ForayMetrics_HomepageCore_ItemCount	int
ForayMetrics_HomepageImageViewer_ItemCount	int
ForayMetrics_HomepageSearchBox_DSQs	int
ForayMetrics_HomepageImageViewer_DSQs	int
ForayMetrics_HomepagePopularNow_DSQs	int
ForayMetrics_HomepageHotSpots_DSQs	int
ForayMetrics_HomepageSearchHistory_DSQs	int
ForayMetrics_HomepageCore_DSQs	int
ForayMetrics_HomepageHOT1_DSQs	int
ForayMetrics_HomepageHOT2_DSQs	int
ForayMetrics_HomepageHOT3_DSQs	int
ForayMetrics_HomepageHOT4_DSQs	int
ForayMetrics_HomepagePGBAR1_DSQs	int
ForayMetrics_HomepagePGBAR2_DSQs	int
ForayMetrics_HomepageMediaControlsCaption_DSQs	int
Metrics_IsHomepageView	boolean
Metrics_IsHomepageIEPageView	boolean
Metrics_IsHomepageDHPPageView	boolean
Metrics_HasHomepageClick	boolean
Metrics_HasHomepageSearch	boolean
Metrics_AllNotificationCloseClickCount	int
Metrics_AllNotificationCloseItemCount	int
Metrics_AllNotificationCallToActionClickCount	int
Metrics_AllNotificationCallToActionItemsCount	int
Metrics_HeroRegionClickCount	int
Metrics_QueryViewCountWithHeroRegionPresent	int
Metrics_QueryViewCountWithHeroRegionClicks	int
Metrics_LocalRegionClickCount	int
Metrics_QueryViewCountWithLocalRegionPresent	int
Metrics_QueryViewCountWithLocalRegionClicks	int
Metrics_QueryViewCountWithLocalHeroRegionPresent	int
Metrics_QueryViewCountWithLocalHeroRegionClicks	int
Metrics_MoviesHeroClickCount	int
Metrics_QueryViewCountWithMoviesHeroPresent	int
Metrics_QueryViewCountWithMoviesHeroClicks	int
Metrics_MusicArtistHeroClickCount	int
Metrics_QueryViewCountWithMusicArtistHeroPresent	int
Metrics_QueryViewCountWithMusicArtistHeroClicks	int
Metrics_BandHeroClickCount	int
Metrics_QueryViewCountWithBandHeroPresent	int
Metrics_QueryViewCountWithBandHeroClicks	int
Metrics_AlbumHeroClickCount	int
Metrics_QueryViewCountWithAlbumHeroPresent	int
Metrics_QueryViewCountWithAlbumHeroClicks	int
Metrics_SongHeroClickCount	int
Metrics_QueryViewCountWithSongHeroPresent	int
Metrics_QueryViewCountWithSongHeroClicks	int
Metrics_PeopleHeroClickCount	int
Metrics_QueryViewCountWithPeopleHeroPresent	int
Metrics_QueryViewCountWithPeopleHeroClicks	int
Metrics_AthleteHeroClickCount	int
Metrics_QueryViewCountWithAthleteHeroPresent	int
Metrics_QueryViewCountWithAthleteHeroClicks	int
Metrics_PlaceCityHeroClickCount	int
Metrics_QueryViewCountWithPlaceCityHeroPresent	int
Metrics_QueryViewCountWithPlaceCityHeroClicks	int
Metrics_PlaceStateHeroClickCount	int
Metrics_QueryViewCountWithPlaceStateHeroPresent	int
Metrics_QueryViewCountWithPlaceStateHeroClicks	int
Metrics_PlaceCountryHeroClickCount	int
Metrics_QueryViewCountWithPlaceCountryHeroPresent	int
Metrics_QueryViewCountWithPlaceCountryHeroClicks	int
Metrics_RestaurantHeroClickCount	int
Metrics_QueryViewCountWithRestaurantHeroPresent	int
Metrics_QueryViewCountWithRestaurantHeroClicks	int
Metrics_HotelHeroClickCount	int
Metrics_QueryViewCountWithHotelHeroPresent	int
Metrics_QueryViewCountWithHotelHeroClicks	int
Metrics_AttractionHeroClickCount	int
Metrics_QueryViewCountWithAttractionHeroPresent	int
Metrics_QueryViewCountWithAttractionHeroClicks	int
Metrics_GoBigAnswerImageHeroClickCount	int
Metrics_QueryViewCountWithGoBigAnswerImageHeroPresent	int
Metrics_QueryViewCountWithGoBigAnswerImageHeroClicks	int
Metrics_GoBigAnswerVideoHeroClickCount	int
Metrics_QueryViewCountWithGoBigAnswerVideoHeroPresent	int
Metrics_QueryViewCountWithGoBigAnswerVideoHeroClicks	int
Metrics_QueryViewCountWithAdsHeroPresent	int
Metrics_QueryViewCountWithAdsHeroClicks	int
Metrics_ClientResultClickCount	int
Metrics_QueryViewCountWithClientResultPresent	int
Metrics_QueryViewCountWithClientResultClicks	int
Metrics_OnlineResultClickCount	int
Metrics_QueryViewCountWithOnlineResultClicks	int
Metrics_QueryViewCountInHorizontalMode	int
Metrics_QueryViewCountInVerticalMode	int
Metrics_QueryViewCountInVerticalNarrowMode	int
Metrics_QueryViewCountInHorizontalLargeMode	int
Metrics_QueryViewCountInVerticalLargeMode	int
Metrics_QueryViewCountInHorizontalModeWithClicks	int
Metrics_QueryViewCountInVerticalModeWithClicks	int
Metrics_QueryViewCountInVerticalNarrowModeWithClicks	int
Metrics_QueryViewCountInHorizontalLargeModeWithClicks	int
Metrics_QueryViewCountInVerticalLargeModeWithClicks	int
Metrics_PageViewCountWithCharmLocalSuggestionSelected	int
Metrics_QueryViewCountWithVisibleAnswers	int
Metrics_QueryViewCountWithVisibleAdPresent	int
Metrics_QueryViewCountWithSwipe	int
Metrics_QueryViewCountWithForwardSwipe	int
Metrics_QueryViewCountWithBackwardSwipe	int
Metrics_QueryViewCountWithTemplateError	int
Metrics_AppStoreAnswerClickCount	int
Metrics_QueryViewCountWithAppStoreAnswerClicks	int
Metrics_QueryViewCountWithAppStoreAnswerPresent	int
Metrics_AppContentAnswerClickCount	int
Metrics_QueryViewCountWithAppContentAnswerClicks	int
Metrics_QueryViewCountWithAppContentAnswerPresent	int
Metrics_WebAppAnnotationAnswerClickCount	int
Metrics_QueryViewCountWithWebAppAnnotationAnswerClicks	int
Metrics_QueryViewCountWithWebAppAnnotationAnswerPresent	int
Metrics_QueryViewCountWithAppAnnotationAnswerClicks	int
Metrics_QueryViewCountWithAppAnnotationAnswerPresent	int
Metrics_FormFactor	string
Metrics_AppInfoClientMajorVersion	string
Metrics_AppInfoClientMinorVersion	string
Metrics_AutoSuggestionCode	string
Metrics_AdsDomainDataSourceClickCount	int
Metrics_AdminUserIsBotCandidate	boolean
Metrics_MobileDistributionChannel	string
Metrics_MobileActivationCount	int
Metrics_MobileUpgradeCount	int
Metrics_SamplePercent	double
Admin_Log_Date	string
Metrics_IEQSAFirstQSParameter	string
Metrics_IEQSAFirstPQParameter	string
Metrics_IEQSAFirstClickPosition	int
Metrics_IEQSAPageViewCount	int
Metrics_IEQSAPageViewCountWithLocalSuggestionsPresent	int
Metrics_IEQSAPageViewCountWithLocalSuggestionsClicks	int
Metrics_IEQSAPageViewCountWithWebSuggestionsPresent	int
Metrics_IEQSAPageViewCountWithWebSuggestionsClicks	int
Metrics_IEQSAPageViewCountWithDomainSuggestionsPresent	int
Metrics_IEQSAPageViewCountWithDomainSuggestionsClicks	int
Metrics_IEQSAPageViewCountWithDirectNavPresent	int
Metrics_IEQSAPageViewCountWithDirectNavClicks	int
Metrics_IEQSAPageViewCountWithDeepLinksPresent	int
Metrics_IEQSAPageViewCountWithDeepLinksClicks	int
Metrics_IEQSAPageViewCountWithFinanceAnswersPresent	int
Metrics_IEQSAPageViewCountWithFinanceAnswersClicks	int
Metrics_IEQSAPageViewCountWithWeatherAnswersPresent	int
Metrics_IEQSAPageViewCountWithWeatherAnswersClicks	int
Metrics_IEQSAPageViewCountWithAppAnswersPresent	int
Metrics_IEQSAPageViewCountWithAppAnswersClicks	int
Metrics_OSMajorVersion	string
Metrics_FirstIosOperation	string
Metrics_FirstIosPreSearchEngine	string
Metrics_FirstIosPostSearchEngine	string
Metrics_FirstIosPopup	string
Metrics_IosInstEventCount	int
Metrics_FirstNotificationCloseItemRegion	string
Metrics_FirstNotificationCallToActionItemRegion	string
Metrics_OSMinorVersion	string
Metrics_IsSchool	boolean
Metrics_SchoolId	string
Metrics_HomepageSearchBox_TTFC	bigint
Metrics_HomepageCarousel_TTFC	bigint
Metrics_HomepageMediaControls_TTFC	bigint
Metrics_HomepageHotspots_TTFC	bigint
Metrics_HomepageCaption_TTFC	bigint
Metrics_HomepageHeader_TTFC	bigint
Metrics_HomepageFooter_TTFC	bigint
Metrics_HomepageSetDHP_ClickCount	int
Metrics_HomepageSetDHP_ItemCount	int
Metrics_HomepageSERPBackstage_DSQs	int
Metrics_HomepageSERPBackstagePrev_DSQs	int
Metrics_HomepageSERPBackstageNext_DSQs	int
Metrics_HomepageSERPBackstageImage_DSQs	int
Metrics_HomepageSERPBackstageLinks_DSQs	int
Metrics_HomepageSERPBackstage_ClickCount	int
Metrics_HomepageSERPBackstagePrev_ClickCount	int
Metrics_HomepageSERPBackstageNext_ClickCount	int
Metrics_HomepageSERPBackstageTweet_ClickCount	int
Metrics_HomepageSERPBackstageShare_ClickCount	int
Metrics_HomepageSERPBackstageImage_ClickCount	int
Metrics_HomepageSERPBackstageLinks_ClickCount	int
Metrics_HomepageSERPBackstage_ItemCount	int
Metrics_HomepageSERPBackstagePrev_ItemCount	int
Metrics_HomepageSERPBackstageNext_ItemCount	int
Metrics_HomepageSERPBackstageTweet_ItemCount	int
Metrics_HomepageSERPBackstageShare_ItemCount	int
Metrics_HomepageSERPBackstageImage_ItemCount	int
Metrics_HomepageSERPBackstageLinks_ItemCount	int
Metrics_QueryViewCountWithGenericEntityHeroPresent	int
Metrics_QueryViewCountWithGenericEntityHeroClicks	int
Metrics_HomepageSERPBackstageTitle_ClickCount	int
Metrics_HomepageSERPBackstageTitle_ItemCount	int
ForayMetrics_HomepageTaskBarPromoTile_DSQs	int
Dataset	string
Metrics_GoBigNavClickCount	int
Metrics_QueryViewCountWithGoBigNavPresent	int
Metrics_QueryViewCountWithGoBigNavClicks	int
Metrics_QueryViewCountWithCoreRegionDCardPresent	int
Metrics_QueryViewCountWithCoreRegionDCardClicks	int
Metrics_EntityHeroClickCount	int
Metrics_QueryViewCountWithEntityHeroPresent	int
Metrics_QueryViewCountWithEntityHeroClicks	int
Metrics_ActorHeroClickCount	int
Metrics_QueryViewCountWithActorHeroPresent	int
Metrics_QueryViewCountWithActorHeroClicks	int
Metrics_ReportingDeviceMakeGroup	string
Metrics_ReportingDisplaySize	string
Page0RawQuery	string
Metrics_UserDefaultPromptAcceptance	string
Foray_Device_Resolution	string
Foray_Device_DeviceType	string
Foray_Device_OSName	string
NewMarket	string
SnrMarket	string
Metrics_ServerAdsHeight	bigint
Metrics_AppInfoClientRevisionNumber	string
Metrics_HalseyTestTraffic	boolean
Metrics_HalseyCortanaScenario	string
HomepagePopNowTileClickCount	int
HomepagePopNowTileItemCount	int
HomepageWeatherTileClickCount	int
HomepageWeatherTileItemCount	int
HomepageNewsTileClickCount	int
HomepageNewsTileItemCount	int
HomepageStockTileClickCount	int
HomepageStockTileItemCount	int
HomepageFlightTileClickCount	int
HomepageFlightTileItemCount	int
HomepagePromoTileClickCount	int
HomepagePromoTileItemCount	int
HomepageWeatherTileDSQs	int
HomepageNewsTileDSQs	int
HomepageStockTileDSQs	int
HomepageFlightTileDSQs	int
Metrics_RelatedInlineItemCount	int
Metrics_RelatedInlineClickCount	int
Metrics_QueryViewCountWithRelatedInlinePresent	int
Metrics_QueryViewCountWithRelatedInlineClicks	int
Metrics_DSENotificationCallToAction	string
Metrics_DSENotificationCallToActionClickCount	int
Metrics_DSENotificationCallToActionCloseItemCount	int
Metrics_HasCortanaChitChats	boolean
Request_CortanaScenario	string
ClientId	string
Request_ImpressionGuid	string
Request_RequestTime	string
FormCode	string
Market	string
Metrics_QueryViewCount	int
Metrics_ReportingAppName	string
Metrics_TrafficCount	int
Reporting_Browser	string
Reporting_IsPageView	boolean
Request_AcquisitionForm	string
Request_DataCenter	string
Request_Domain	string
Request_FexBuild	string
Request_FrontDoorImpressionEventId	string
Request_IEVersion	string
Request_ImpressionType	string
Request_TrueMarket	string
Session_FirstFormCode	string
Metrics_Overall_PLT	bigint
Metrics_AppMajorVersion	int
Metrics_AppInfoClientName	string
Metrics_AppType	string
Metrics_BrowserBrand	string
Metrics_DeviceModel	string
ForayMetrics_AllVisibleAnswerClickTimestamps	string
ForayMetrics_AllVisibleAnswerClickWebDwellTimes	string
ForayMetrics_AllVisibleAdClickTimestamps	string
ForayMetrics_AllVisibleAdClickWebDwellTimes	string
ForayMetrics_AllVisibleWebClickTimestamps	string
ForayMetrics_AllVisibleWebClickWebDwellTimes	string
ForayMetrics_ScopeBarRegionClickTimestamps	string
ForayMetrics_ScopeBarRegionClickWebDwellTimes	string
ForayMetrics_AnswerBarRegionClickTimestamps	string
ForayMetrics_AnswerBarRegionClickWebDwellTimes	string
Foray_AllFlightFactors	string
Foray_AllFlightLevels	string
ForayMetrics_CoreResultsRegionClickUrls	string
Metrics_DisplaySize	string
Page_PageNumber	int
Request_Referrer	string
User_Ip	string
Reporting_BingBarVersion	string
Metrics_DeviceMake	string
Metrics_AppMinorVersion	int
Session_FirstPartnerCode	string
Request_PartnerCode	string
Metrics_DeviceType	string
Request_Url	string
Request_UserAgent	string
Metrics_AppInfoServerName	string
Metrics_OSProductName	string
Foray_ReverseIpCountry	string
Foray_ReverseIpPostalCode	string
Foray_RawMUID	string
Foray_ReverseIpCountryIso	string
Request_Platform	string
Vertical	string
Foray_ReverseIpTimeZone	string
Admin_User_HasCookies	boolean
Foray_ReverseIpState	string
Foray_ReverseIpCity	string
Admin_User_StartedWithMuid	boolean
Reporting_IsExplicitCore	boolean
Reporting_IsExplicitTrue	boolean
Page_Name	string
User_SafeSearchSetting	string
Session_PageViewSequenceNumber	int
Foray_FLT1NumberLine	string
Request_IsInteractivePageView	boolean
ForayMetrics_PPDataCount	int
Foray_ReverseIpRegion	string
Metrics_ItemCount	int
Metrics_QueryViewCountWithItemPresent	int
Metrics_IsTouchDevice	boolean
Metrics_HeaderItemCount	int
Metrics_QueryViewCountWithHeaderPresent	int
Metrics_QueryViewCountWithScopeBarPresent	int
Metrics_ScopeBarItemCount	int
Metrics_FooterItemCount	int
Metrics_QueryViewCountWithFooterPresent	int
Session_FollowOn_FormCode	string
Session_FollowOn_PartnerFormCode	string
Metrics_CoreItemCount	int
Metrics_QueryViewCountWithCorePresent	int
Query_RawQuery	string
Query_IsNormal	boolean
Metrics_QueryViewCountWithResultsPresent	int
Metrics_ResultsItemCount	int
Metrics_QueryViewCountWithResultsPos01Present	int
Metrics_ResultsPos01ItemCount	int
Metrics_CoreResultItemCount	int
Metrics_QueryViewCountWithResultsPos02Present	int
Metrics_ResultsPos02ItemCount	int
Metrics_QueryViewCountWithResultsPos03Present	int
Metrics_ResultsPos03ItemCount	int
Metrics_QueryViewCountWithResultsPos04Present	int
Metrics_ResultsPos04ItemCount	int
Metrics_QueryViewCountWithResultsPos05Present	int
Metrics_ResultsPos05ItemCount	int
Metrics_QueryViewCountWithResultsPos06Present	int
Metrics_ResultsPos06ItemCount	int
Metrics_QueryViewCountWithResultsPos07Present	int
Metrics_ResultsPos07ItemCount	int
Metrics_QueryViewCountWithResultsPos08Present	int
Metrics_ResultsPos08ItemCount	int
Metrics_VisitCount_Query_Market_Form_Vertical	int
Metrics_VisitCount_Query_Market_Form	int
Metrics_QueryViewCountWithWebIndexPresent	int
Metrics_WebIndexItemCount	int
Metrics_EntityResultsWebIndexTitleLinkItemCount	int
Metrics_QueryViewCountWithEntityResultsWebIndexTitleLinkPresent	int
Metrics_CoreWebIndexItemCount	int
Metrics_QueryViewCountWithCoreWebIndexPresent	int
Metrics_EntityResultsCachedPageLinkItemCount	int
Metrics_QueryViewCountWithEntityResultsCachedPageLinkPresent	int
Metrics_CoreBottomItemCount	int
Metrics_QueryViewCountWithCoreBottomPresent	int
Metrics_PaginationItemCount	int
Metrics_QueryViewCountWithPaginationPresent	int
Metrics_CoreBottomPaginationItemCount	int
Metrics_QueryViewCountWithResultsPos09Present	int
Metrics_ResultsPos09ItemCount	int
Metrics_AnswerItemCount	int
Metrics_QueryViewCountWithAnswerPresent	int
Request_AdRequestProvider	string
Page_DistinctQueryCountVerticalChangeWithinVisit	int
Metrics_DistinctQueryCountVerticalWithinVisit	int
Reporting_DistinctQueryInSessionAndVertical	int
Metrics_VisitCount_Query_Market_Vertical_VisitForm	int
Metrics_VisitCount_Query_Market_Vertical	int
Metrics_QueryViewCountWithRightRailPresent	int
Metrics_RightRailItemCount	int
Metrics_DistinctQueryCountVertical	int
Metrics_QueryViewCountWithRelatedPresent	int
Metrics_RelatedItemCount	int
Metrics_DistinctQueryCountWithinVisit	int
Metrics_PageViewCountWithClicks	int
Metrics_ClickCount	int
Metrics_QueryViewCountWithClicks	int
Metrics_TotalLinkClickCount	int
Metrics_TotalTimeToLastClick	double
Metrics_TotalTimeToFirstClick	double
Metrics_UserCount_Query_Market_Form_Vertical	int
Metrics_DistinctQueryCount	int
Metrics_BrowserMode	string
Request_AdUnitId	string
Metrics_CoreAnswerItemCount	int
Metrics_QueryViewCountWithCoreAnswerPresent	int
Metrics_QueryViewCountWithRightRailRelatedPresent	int
Metrics_RightRailRelatedItemCount	int
User_SessionSequenceNumber	int
Metrics_UserCount_Query_Market_Form	int
Metrics_QueryViewCountWithRelatedQSDefaultPresent	int
Metrics_RelatedQSDefaultItemCount	int
ForayMetrics_PSkipClassicWholePageTrialCount	int
ForayMetrics_PSkipCoreOnlyTrialCount	int
Metrics_CoreClickCount	int
Metrics_QueryViewCountWithCoreClicks	int
Metrics_UserCount_Query_Market_Vertical_VisitForm	int
Metrics_InlineQSItemCount	int
Metrics_QueryViewCountWithInlineQSPresent	int
Metrics_ResultsTrialCount	int
Metrics_UserCount_Query_Market_Vertical	int
Metrics_AlgoClickCount	int
Metrics_QueryViewCountWithResultsClicks	int
Metrics_ResultsClickCount	int
Metrics_CoreResultClickCount	int
Metrics_CoreTopItemCount	int
Metrics_QueryViewCountWithCoreTopPresent	int
Metrics_VisitCount_Query_Market_VisitForm	int
Metrics_VisitCount_Query_Market	int
Metrics_QueryViewCountWithWebIndexClicks	int
Metrics_WebIndexClickCount	int
Metrics_CoreWebIndexClickCount	int
Metrics_QueryViewCountWithCoreWebIndexClicks	int
Metrics_QueryViewCountWithSuccessClicks	int
Metrics_SuccessClickCount	int
Metrics_FBIPEnabled	string
Metrics_QueryViewCountWithWebVerticalResultAndVerticalLinkSuccessClicks	int
Metrics_QueryViewCountWithIntegratedSearchFeaturePresent	int
Metrics_QueryViewCountWithWebVerticalResultSuccessClicks	int
Metrics_EntityResultsWebIndexTitleLinkClickCount	int
Metrics_QueryViewCountWithEntityResultsWebIndexTitleLinkClicks	int
Metrics_CoreSuccessClickCount	int
Metrics_QueryViewCountWithCoreSuccessClicks	int
Metrics_QueryViewCountWithResultsSuccessClicks	int
Metrics_ResultsSuccessClickCount	int
Metrics_CoreResultSuccessClickCount	int
Metrics_QueryViewCountWithCoreResultSuccessClicks	int
User_Anid	string
Metrics_QueryViewCountWithResultsPos10Present	int
Metrics_ResultsPos10ItemCount	int
Metrics_QueryViewCountWithWebIndexSuccessClicks	int
Metrics_WebIndexSuccessClickCount	int
Metrics_CoreWebIndexSuccessClickCount	int
Metrics_QueryViewCountWithCoreWebIndexSuccessClicks	int
User_IsNew	boolean
Metrics_AdItemCount	int
Metrics_QueryViewCountWithAdPresent	int
Metrics_InlineAnswerItemCount	int
Metrics_QueryViewCountWithInlineAnswerPresent	int
Metrics_UserCount_Query_Market_VisitForm	int
Metrics_NotificationItemCount	int
Metrics_QueryViewCountWithNotificationPresent	int
Metrics_QueryViewCountWithFilterBarPresent	int
ForayMetrics_PSkipClassicWholePageSkipCount	int
Metrics_QueryViewCountWithRightPanePresent	int
Metrics_RightPaneItemCount	int
Metrics_QueryViewCountWithRightPanePostControlRegionPresent	int
Metrics_UserCount_Query_Market	int
Metrics_QueryViewCountWithResultsPos01Clicks	int
Metrics_ResultsPos01ClickCount	int
Metrics_QueryViewCountWithResultForceToBottomAnswerPresent	int
Metrics_ResultForceToBottomAnswerItemCount	int
Metrics_QueryViewCountWithRightPaneUpsellRegionPresent	int
Metrics_BOPEntityInlineQSItemCount	int
Metrics_QueryViewCountWithBOPEntityInlineQSPresent	int
ForayMetrics_PSkipCoreOnlySkipCount	int
Session_FollowOn_SequenceNumber	int
Metrics_IntegratedSearchFilterBarItemCount	int
Metrics_QueryViewCountWithIntegratedSearchFilterBarPresent	int
Metrics_EntityResultsSiteDataLinkItemCount	int
Metrics_QueryViewCountWithEntityResultsSiteDataLinkPresent	int
Metrics_QueryViewCountWithRightRailAdPresent	int
Metrics_RightRailAdItemCount	int
Metrics_QuickBackClickCount	int
Metrics_QueryViewCountWithWebIndexDeeplinkPresent	int
Metrics_WebIndexDeeplinkItemCount	int
Foray_IsFacebookUser	boolean
Metrics_ResultsSkipCount	int
User_UpAnid	string
Metrics_QueryViewCountWithAutosuggestPresent	int
Metrics_MOPEntityInlineQSItemCount	int
Metrics_QueryViewCountWithMOPEntityInlineQSPresent	int
Metrics_CoreTopAdItemCount	int
Metrics_QueryViewCountWithCoreTopAdPresent	int
Metrics_DCardItemCount	int
Metrics_QueryViewCountWithDCardPresent	int
Metrics_DCardWebIndexItemCount	int
Metrics_DCardWebIndexTitleLinkItemCount	int
Metrics_DominantResultWebIndexItemCount	int
Metrics_QueryViewCountWithDCardWebIndexPresent	int
Metrics_QueryViewCountWithDCardWebIndexTitleLinkPresent	int
Metrics_QueryViewCountWithDominantResultWebIndexPresent	int
Metrics_CoreBottomAdItemCount	int
Metrics_QueryViewCountWithCoreBottomAdPresent	int
Metrics_QueryViewCountWithAutosuggestClicks	int
Metrics_DCardWebIndexDeeplinkItemCount	int
Metrics_QueryViewCountWithDCardWebIndexDeeplinkPresent	int
Metrics_CoreQuickBackClickCount	int
Metrics_DCardClickCount	int
Metrics_QueryViewCountWithDCardClicks	int
Metrics_DCardWebIndexClickCount	int
Metrics_DominantResultWebIndexClickCount	int
Metrics_QueryViewCountWithDCardWebIndexClicks	int
Metrics_QueryViewCountWithDominantResultWebIndexClicks	int
Metrics_DCardSuccessClickCount	int
Metrics_QueryViewCountWithDCardSuccessClicks	int
Metrics_DCardWebIndexSuccessClickCount	int
Metrics_DominantResultWebIndexSuccessClickCount	int
Metrics_QueryViewCountWithDCardWebIndexSuccessClicks	int
Metrics_QueryViewCountWithDominantResultWebIndexSuccessClicks	int
Metrics_EntityResultsTranslateLinkItemCount	int
Metrics_QueryViewCountWithEntityResultsTranslateLinkPresent	int
Metrics_AutosuggestClickCount	int
Metrics_QueryViewCountWithTopAnswerPresent	int
Metrics_TopAnswerItemCount	int
Metrics_DCardWebIndexTitleLinkClickCount	int
Metrics_QueryViewCountWithDCardWebIndexTitleLinkClicks	int
Metrics_ResultsQuickBackClickCount	int
Metrics_CoreResultQuickBackClickCount	int
Metrics_DCardWebIndexTitleLinkSuccessClickCount	int
Metrics_QueryViewCountWithDCardWebIndexTitleLinkSuccessClicks	int
Request_AppId	string
Metrics_LeftRailItemCount	int
Metrics_QueryViewCountWithLeftRailPresent	int
Metrics_ExploreItemCount	int
Metrics_QueryViewCountWithExplorePresent	int
User_IsWindowsLiveUser	boolean
ForayMetrics_HomepageOverall_ItemCount	int
Metrics_QueryViewCountWithWebIndexFreshPresent	int
Metrics_WebIndexFreshItemCount	int
ForayMetrics_HomepageFooter_ItemCount	int
ForayMetrics_HomepageNetworkLinks_ItemCount	int
ForayMetrics_HomepageScopeBar_ItemCount	int
ForayMetrics_HomepageSearchBox_ItemCount	int
ForayMetrics_HomepageMediaControlsOverall_ItemCount	int
ForayMetrics_HomepageHeader_ItemCount	int
ForayMetrics_HomepageMediaControlsCaption_ItemCount	int
Metrics_QueryViewCountWithSearchHistoryPresent	int
Metrics_SearchHistoryItemCount	int
Metrics_CorrectionItemCount	int
Metrics_QueryViewCountWithCorrectionPresent	int
Metrics_CoreTopCorrectionItemCount	int
Metrics_QueryViewCountWithCoreTopCorrectionPresent	int
Metrics_QueryViewCountWithResultsPos02Clicks	int
Metrics_ResultsPos02ClickCount	int
Metrics_QueryViewCountWithWebIndexQuasiSFPresent	int
Metrics_WebIndexQuasiSFItemCount	int
Metrics_CoreBottomCorrectionItemCount	int
Metrics_QueryViewCountWithCoreBottomCorrectionPresent	int
Metrics_DCardLastClickCount	int
Metrics_DCardWebIndexLastClickCount	int
Metrics_QueryViewCountWithAllRichCaptionPresent	int
Metrics_DCardWebIndexSiteSearchItemCount	int
Metrics_QueryViewCountWithDCardWebIndexSiteSearchPresent	int
Metrics_QueryViewCountWithCoreResultsDocPreviewPresent	int
Metrics_QueryViewCountWithCoreResultsDocPreview2OrMorePresent	int
Metrics_QueryViewCountWithTaskPanePresent	int
Metrics_QueryViewCountWithCoreResultsDocPreview3OrMorePresent	int
Metrics_QueryViewCountWithCoreResultsDocPreview4OrMorePresent	int
Metrics_QueryViewCountWithCoreResultsDocPreview5OrMorePresent	int
Metrics_FacebookPermissionsReceived	string
Metrics_DCardWebIndexTitleLinkLastClickCount	int
Metrics_WebIndexQuickBackClickCount	int
Metrics_CoreWebIndexQuickBackClickCount	int
ForayMetrics_HomepageHotspots_ItemCount	int
Metrics_QueryViewCountWithRightPanePersonalizedDataPresent	int
Metrics_RightPanePersonalizedDataItemCount	int
Metrics_QueryViewCountWithExpertListRegionPresent	int
Metrics_RightPaneExpertListRegionItemCount	int
ForayMetrics_HomepageProgramBarOverall_ItemCount	int
Metrics_QueryViewCountWithExpandoPresent	int
Metrics_QueryViewCountWithResultsPos03Clicks	int
Metrics_ResultsPos03ClickCount	int
Metrics_QueryViewCountWithRecentSearchHistoryPresent	int
Metrics_RecentSearchHistoryItemCount	int
Metrics_AnswerClickCount	int
Metrics_QueryViewCountWithAnswerClicks	int
Request_QuickQuerySequence	string
ForayMetrics_HomepageTaskFlyout_ItemCount	int
Metrics_CoreAnswerClickCount	int
Metrics_QueryViewCountWithCoreAnswerClicks	int
Metrics_IsRewardsUser	boolean
Metrics_QueryViewCountFromRelatedSearch	int
Metrics_RelatedTrialCount	int
Metrics_AnswerQuickBackClickCount	int
ForayMetrics_HomepageTBOveralll_ItemCount	int
ForayMetrics_HomepageTBPopNowTile_ItemCount	int
Metrics_QueryViewCountWithTimeFilterPresent	int
Metrics_TimeFilterItemCount	int
Metrics_QueryViewCountWithResultsPos04Clicks	int
Metrics_ResultsPos04ClickCount	int
Metrics_AbandonmentPerfPingCount	int
Metrics_CoreTopClickCount	int
Metrics_QueryViewCountWithCoreTopClicks	int
Metrics_CoreAnswerQuickBackClickCount	int
Metrics_CoreTopAdTrialCount	int
Metrics_CoreBottomClickCount	int
Metrics_QueryViewCountWithCoreBottomClicks	int
Metrics_QueryViewCountWithChildAnswerPresent	int
ForayMetrics_HomepageTBImagesTile_ItemCount	int
ForayMetrics_HomepageTBVideoTile_ItemCount	int
Metrics_PaginationClickCount	int
Metrics_QueryViewCountWithPaginationClicks	int
Metrics_CoreBottomQuickBackClickCount	int
Metrics_CoreBottomPaginationClickCount	int
Metrics_QueryViewCountWithWebIndexSuperFreshPresent	int
Metrics_WebIndexSuperFreshItemCount	int
Metrics_RelatedSkipCount	int
Metrics_PaginationQuickBackClickCount	int
Metrics_CoreBottomPaginationQuickBackClickCount	int
ForayMetrics_HomepageOverall_ClickCount	int
Metrics_QueryViewCountWithRelatedClicks	int
Metrics_RelatedClickCount	int
Metrics_RelatedQuickBackClickCount	int
ForayMetrics_AllAnswersWinCount	double
ForayMetrics_HomepageTBHistoryTile_ItemCount	int
Metrics_AdClickCount	int
Metrics_QueryViewCountWithAdClicks	int
Metrics_AdRevenue	double
Metrics_QueryViewCountWithResultsPos05Clicks	int
Metrics_ResultsPos05ClickCount	int
Metrics_CoreTopAdClickCount	int
Metrics_QueryViewCountWithCoreTopAdClicks	int
Metrics_QueryViewCountWithTOPEntityInlineQSPresent	int
Metrics_QueryViewCountWithWebIndexDeeplinkClicks	int
Metrics_WebIndexDeeplinkClickCount	int
ForayMetrics_HomepageTaskFlyoutSearchHistory_ItemCount	int
Metrics_QueryViewCountWithWebIndexDeeplinkSuccessClicks	int
Metrics_WebIndexDeeplinkSuccessClickCount	int
ForayMetrics_HomepageSearchBox_ClickCount	int
Metrics_HeaderClickCount	int
Metrics_QueryViewCountWithHeaderClicks	int
Metrics_QueryViewCountWithRightRailClicks	int
Metrics_RightRailClickCount	int
Metrics_AdSuccessClickCount	int
Metrics_QueryViewCountWithAdSuccessClicks	int
ForayMetrics_AllAnswersLossCount	double
Metrics_QueryViewCountWithScopeBarClicks	int
Metrics_ScopeBarClickCount	int
Metrics_HeaderQuickBackClickCount	int
Metrics_QueryViewCountWithResultsPos06Clicks	int
Metrics_ResultsPos06ClickCount	int
Metrics_ScopeBarQuickBackClickCount	int
Metrics_CoreTopSuccessClickCount	int
Metrics_QueryViewCountWithCoreTopSuccessClicks	int
Metrics_CoreTopAdSuccessClickCount	int
Metrics_QueryViewCountWithCoreTopAdSuccessClicks	int
Metrics_RightRailQuickBackClickCount	int
Metrics_QueryViewCountWithTopAnswerClicks	int
Metrics_TopAnswerClickCount	int
ForayMetrics_TopAnswersWinCount	double
Metrics_DCardWebIndexDeeplinkClickCount	int
Metrics_QueryViewCountWithDCardWebIndexDeeplinkClicks	int
Metrics_QueryViewCountWithCoreResultsDocPreviewClicks	int
Metrics_QueryViewCountWithRightRailRelatedClicks	int
Metrics_RightRailRelatedClickCount	int
Metrics_QueryViewCountWithResultsPos07Clicks	int
Metrics_ResultsPos07ClickCount	int
Metrics_DCardWebIndexDeeplinkSuccessClickCount	int
Metrics_QueryViewCountWithDCardWebIndexDeeplinkSuccessClicks	int
Metrics_InlineAnswerClickCount	int
Metrics_QueryViewCountWithInlineAnswerClicks	int
Metrics_QueryViewCountWithRelatedQSDefaultClicks	int
Metrics_RelatedQSDefaultClickCount	int
Metrics_RelatedQSDefaultQuickBackClickCount	int
Metrics_QueryViewCountWithLeftRailExploreRelatedPresent	int
Metrics_QueryViewCountWithResultsPos08Clicks	int
Metrics_ResultsPos08ClickCount	int
Metrics_QueryViewCountWithDCardWebIndexExternalWebSearchPresent	int
Metrics_CoreTopAdSkipCount	int
Metrics_InlineAnswerQuickBackClickCount	int
Metrics_CoreTopQuickBackClickCount	int
Metrics_DCardAnswerItemCount	int
Metrics_QueryViewCountWithDCardAnswerPresent	int
Metrics_WebIndexDeeplinkLastClickCount	int
Metrics_TopAnswerQuickBackClickCount	int
Metrics_RightRailAdTrialCount	int
ForayMetrics_TopAnswersLossCount	double
Metrics_QueryViewCountWithResultsPos09Clicks	int
Metrics_ResultsPos09ClickCount	int
Metrics_RightRailAdSkipCount	int
Metrics_QueryViewCountWithNoResult	int
Metrics_InlineQSClickCount	int
Metrics_QueryViewCountWithInlineQSClicks	int
ForayMetrics_ImageAnswersWinCount	double
Metrics_InlineQSQuickBackClickCount	int
ForayMetrics_MopAnswersWinCount	double
Metrics_DCardWebIndexDeeplinkLastClickCount	int
Metrics_AnswerSuccessClickCount	int
Metrics_QueryViewCountWithAnswerSuccessClicks	int
Metrics_NotificationClickCount	int
Metrics_QueryViewCountWithNotificationClicks	int
Metrics_NotificationQuickBackClickCount	int
ForayMetrics_MopAnswersLossCount	double
Request_IsMarketingTraffic	boolean
ForayMetrics_ImageAnswersLossCount	double
Metrics_CoreAnswerSuccessClickCount	int
Metrics_QueryViewCountWithCoreAnswerSuccessClicks	int
Metrics_CoreBottomAdTrialCount	int
Metrics_CorrectionClickCount	int
Metrics_QueryViewCountWithCorrectionClicks	int
Metrics_CorrectionQuickBackClickCount	int
Metrics_DCardQuickBackClickCount	int
Metrics_DCardWebIndexQuickBackClickCount	int
Metrics_DominantResultWebIndexQuickBackClickCount	int
Metrics_CoreBottomAdSkipCount	int
Metrics_QueryViewCountWithResultsPos10Clicks	int
Metrics_ResultsPos10ClickCount	int
Metrics_CoreTopCorrectionClickCount	int
Metrics_QueryViewCountWithCoreTopCorrectionClicks	int
Metrics_CoreTopCorrectionQuickBackClickCount	int
Metrics_AdQuickBackClickCount	int
ForayMetrics_VideoAnswersWinCount	double
ForayMetrics_NewsAnswersWinCount	double
Metrics_DCardWebIndexTitleLinkQuickBackClickCount	int
Metrics_CoreTopAdQuickBackClickCount	int
Metrics_QueryViewCountWithWebIndexSuperFreshQuasiSFPresent	int
Metrics_WebIndexSuperFreshQuasiSFItemCount	int
Metrics_QueryViewCountWithTopAnswerSuccessClicks	int
Metrics_TopAnswerSuccessClickCount	int
Metrics_MOPEntityInlineQSClickCount	int
Metrics_QueryViewCountWithMOPEntityInlineQSClicks	int
Metrics_MOPEntityInlineQSQuickBackClickCount	int
Metrics_QueryViewCountWithWebIndexFreshClicks	int
Metrics_WebIndexFreshClickCount	int
Metrics_QueryViewCountWithResultForceToBottomAnswerClicks	int
Metrics_ResultForceToBottomAnswerClickCount	int
Metrics_BingAppInitialViewMode	string
Metrics_DeviceDPI	string
Metrics_QueryViewCountInLandscapeMode	int
Request_IsInternalTraffic	boolean
User_HasMsIp	boolean
Metrics_BOPEntityInlineQSClickCount	int
Metrics_QueryViewCountWithBOPEntityInlineQSClicks	int
Metrics_IsBingAppHomePage	boolean
Metrics_BOPEntityInlineQSQuickBackClickCount	int
ForayMetrics_VideoAnswersLossCount	double
Metrics_QueryViewCountWithWebIndexFreshSuccessClicks	int
Metrics_WebIndexFreshSuccessClickCount	int
Metrics_CorePaginationItemCount	int
Metrics_QueryViewCountWithWebIndexQuasiSFClicks	int
Metrics_WebIndexQuasiSFClickCount	int
Metrics_QueryViewCountWithRichAdPresent	int
Metrics_RichAdItemCount	int
Metrics_QueryViewCountWithWebIndexQuasiSFSuccessClicks	int
Metrics_WebIndexQuasiSFSuccessClickCount	int
ForayMetrics_NewsAnswersLossCount	double
Metrics_LeftRailClickCount	int
Metrics_QueryViewCountWithLeftRailClicks	int
Metrics_ExploreClickCount	int
Metrics_QueryViewCountWithExploreClicks	int
Metrics_AdultAdItemCount	int
Metrics_QueryViewCountWithAdultAdPresent	int
Metrics_LeftRailQuickBackClickCount	int
Metrics_ExploreQuickBackClickCount	int
ForayMetrics_HomepageScopeBar_ClickCount	int
Metrics_IntegratedSearchFeatureClickCount	int
Metrics_QueryViewCountWithIntegratedSearchFeatureClicks	int
Request_ClientType	string
Metrics_QueryViewCountWithRightRailAdClicks	int
Metrics_RightRailAdClickCount	int
Metrics_IsARMDevice	boolean
ForayMetrics_HomepageTaskBarOverall_DSQs	int
Metrics_QueryViewCountWithRightRailSuccessClicks	int
Metrics_RightRailSuccessClickCount	int
ForayMetrics_PhonebookAnswersWinCount	double
ForayMetrics_HomepageTBOverall_ClickCount	int
Metrics_NavBarItemCount	int
Metrics_QueryViewCountWithNavBarPresent	int
Metrics_AnswerBarItemCount	int
Metrics_QueryViewCountWithAnswerBarPresent	int
Metrics_NavBarHeaderPageTitleItemCount	int
Metrics_QueryViewCountWithNavBarHeaderPageTitlePresent	int
Metrics_QueryViewCountWithZoomOutRelatedRegionLogged	int
Metrics_CoreResultsDocPreviewEmbeddedItemCount	int
Metrics_QueryViewCountWithCoreResultsDocPreviewEmbeddedPresent	int
Metrics_WebIndexFreshLastClickCount	int
Metrics_InlineAnswerSuccessClickCount	int
Metrics_QueryViewCountWithInlineAnswerSuccessClicks	int
Metrics_WebIndexDeeplinkQuickBackClickCount	int
ForayMetrics_PhonebookAnswersLossCount	double
Metrics_QueryViewCountInLandscapeModeWithClicks	int
Metrics_QueryViewCountWithRightRailAdSuccessClicks	int
Metrics_RightRailAdSuccessClickCount	int
Metrics_AppInfoServerVersion	string
Metrics_QueryViewCountWithRelevantPeopleListRegionPresent	int
Metrics_RightPaneRelevantPeopleListRegionItemCount	int
Metrics_WebIndexQuasiSFLastClickCount	int
ForayMetrics_HomepageTaskBarPopNowTile_DSQs	int
Metrics_DCardWebIndexSiteSearchClickCount	int
Metrics_QueryViewCountWithDCardWebIndexSiteSearchClicks	int
Metrics_DCardWebIndexSiteSearchSuccessClickCount	int
Metrics_QueryViewCountWithDCardWebIndexSiteSearchSuccessClicks	int
ForayMetrics_HomepageNetworkLinks_ClickCount	int
Metrics_CoreBottomSuccessClickCount	int
Metrics_QueryViewCountWithCoreBottomSuccessClicks	int
ForayMetrics_CommerceAnswersLossCount	double
ForayMetrics_HomepageMediaControlsOverall_ClickCount	int
Metrics_QueryViewCountWithWebIndexSuperFreshClicks	int
Metrics_WebIndexSuperFreshClickCount	int
Metrics_HeaderSuccessClickCount	int
Metrics_QueryViewCountWithHeaderSuccessClicks	int
Metrics_QueryViewCountWithTaskPaneClicks	int
Metrics_TaskPaneClickCount	int
ForayMetrics_CommerceAnswersWinCount	double
Metrics_QueryViewCountWithRichAdClicks	int
Metrics_RichAdClickCount	int
Metrics_DCardWebIndexDeeplinkQuickBackClickCount	int
ForayMetrics_HomepageTBHistoryTile_ClickCount	int
Metrics_QueryViewCountWithLeftRailExploreRelatedClicks	int
Metrics_WebIndexFreshQuickBackClickCount	int
Metrics_QueryViewCountWithRichAdSuccessClicks	int
Metrics_RichAdSuccessClickCount	int
Metrics_CoreBottomAdClickCount	int
Metrics_QueryViewCountWithCoreBottomAdClicks	int
Metrics_QueryViewCountWithWebIndexSuperFreshSuccessClicks	int
Metrics_WebIndexSuperFreshSuccessClickCount	int
Metrics_QueryViewCountWithExpandoOpen	int
ForayMetrics_HomepageHeader_ClickCount	int
Metrics_DCardWebIndexSiteSearchLastClickCount	int
ForayMetrics_HomepageTBPopNowTile_ClickCount	int
Metrics_WebIndexQuasiSFQuickBackClickCount	int
Metrics_QueryViewCountWithTOPEntityInlineQSClicks	int
Metrics_QueryViewCountWithDCardWebIndexExternalWebSearchClicks	int
Metrics_ScrollCount	int
Metrics_QueryViewCountWithSearchHistoryClicks	int
Metrics_SearchHistoryClickCount	int
Metrics_SearchHistoryQuickBackClickCount	int
Metrics_QueryViewCountWithScopeBarSuccessClicks	int
Metrics_ScopeBarSuccessClickCount	int
ForayMetrics_HomepageTaskBarHistoryTile_DSQs	int
ForayMetrics_HomepageHotspots_ClickCount	int
Metrics_PaginationSuccessClickCount	int
Metrics_QueryViewCountWithPaginationSuccessClicks	int
Metrics_CoreBottomPaginationSuccessClickCount	int
Metrics_QueryViewCountWithCoreBottomPaginationSuccessClicks	int
ForayMetrics_BopAnswersWinCount	double
ForayMetrics_HomepageScopeBarNoFlyout_DSQs	int
Metrics_CoreBottomAdSuccessClickCount	int
Metrics_QueryViewCountWithCoreBottomAdSuccessClicks	int
Metrics_RightRailAdQuickBackClickCount	int
Metrics_QueryViewCountWithRelatedSuccessClicks	int
Metrics_RelatedSuccessClickCount	int
Metrics_EntityResultsTranslateLinkClickCount	int
Metrics_QueryViewCountWithEntityResultsTranslateLinkClicks	int
Metrics_CoreBottomCorrectionClickCount	int
Metrics_QueryViewCountWithCoreBottomCorrectionClicks	int
Metrics_CoreBottomCorrectionQuickBackClickCount	int
Metrics_AllRichCaptionClickCount	int
Metrics_QueryViewCountWithAllRichCaptionClicks	int
ForayMetrics_BopAnswersLossCount	double
Metrics_WebIndexSuperFreshLastClickCount	int
Metrics_FilterBarClickCount	int
Metrics_QueryViewCountWithFilterBarClicks	int
Metrics_IntegratedSearchFilterBarClickCount	int
Metrics_QueryViewCountWithIntegratedSearchFilterBarClicks	int
Metrics_EntityResultsTranslateLinkSuccessClickCount	int
Metrics_QueryViewCountWithEntityResultsTranslateLinkSuccessClicks	int
Metrics_EntityResultsSiteDataLinkClickCount	int
Metrics_QueryViewCountWithEntityResultsSiteDataLinkClicks	int
Metrics_FooterClickCount	int
Metrics_QueryViewCountWithFooterClicks	int
Metrics_QueryViewCountWithWebIndexSuperFreshQuasiSFClicks	int
Metrics_WebIndexSuperFreshQuasiSFClickCount	int
Metrics_CoreBottomAdQuickBackClickCount	int
Metrics_ChildAnswerClickCount	int
Metrics_QueryViewCountWithChildAnswerClicks	int
ForayMetrics_HomepageProgramBarOverall_ClickCount	int
Metrics_QueryViewCountWithRelatedQSDefaultSuccessClicks	int
Metrics_RelatedQSDefaultSuccessClickCount	int
Metrics_CorePaginationClickCount	int
Metrics_CorePaginationQuickBackClickCount	int
Metrics_EntityResultsCachedPageLinkClickCount	int
Metrics_QueryViewCountWithEntityResultsCachedPageLinkClicks	int
Metrics_QueryViewCountWithWebIndexSuperFreshQuasiSFSuccessClicks	int
Metrics_WebIndexSuperFreshQuasiSFSuccessClickCount	int
Metrics_NotificationSuccessClickCount	int
Metrics_QueryViewCountWithNotificationSuccessClicks	int
ForayMetrics_HomepageMediaControlsCaption_ClickCount	int
Metrics_FooterSuccessClickCount	int
Metrics_QueryViewCountWithFooterSuccessClicks	int
ForayMetrics_HomepageTaskFlyout_ClickCount	int
Metrics_WebIndexSuperFreshQuickBackClickCount	int
Metrics_QueryViewCountWithDCardWebIndexPackageSearchPresent	int
Metrics_QueryViewCountWithRecentSearchHistoryClicks	int
Metrics_RecentSearchHistoryClickCount	int
ForayMetrics_HomepageScopeBarTaskFlyout_DSQs	int
Metrics_InlineQSSuccessClickCount	int
Metrics_QueryViewCountWithInlineQSSuccessClicks	int
Metrics_RelatedQSDefaultLastClickCount	int
Metrics_EntityResultsCachedPageLinkSuccessClickCount	int
ForayMetrics_HomepageTaskFlyoutSearchHistory_ClickCount	int
ForayMetrics_HomepageTBImagesTile_ClickCount	int
Metrics_CorrectionSuccessClickCount	int
Metrics_QueryViewCountWithCorrectionSuccessClicks	int
Metrics_AdultAdClickCount	int
Metrics_QueryViewCountWithAdultAdClicks	int
Metrics_WebIndexSuperFreshQuasiSFLastClickCount	int
ForayMetrics_HomepageTaskBarImagesTile_DSQs	int
Metrics_EntityResultsTranslateLinkQuickBackClickCount	int
Metrics_InlineQSLastClickCount	int
Metrics_CoreTopCorrectionSuccessClickCount	int
Metrics_QueryViewCountWithCoreTopCorrectionSuccessClicks	int
Metrics_RichAdQuickBackClickCount	int
Metrics_QueryViewCountWithRightPaneEngagement	int
Metrics_RightPaneEngagementCount	int
Metrics_QueryViewCountWithRightPaneRealEngagement	int
Metrics_RightPaneRealEngagementCount	int
Metrics_QueryViewCountWithRightPaneClicks	int
Metrics_RightPaneClickCount	int
Metrics_BOPEntityInlineQSSuccessClickCount	int
Metrics_QueryViewCountWithBOPEntityInlineQSSuccessClicks	int
Metrics_EntityResultsCachedPageLinkQuickBackClickCount	int
Metrics_AdultAdSuccessClickCount	int
Metrics_QueryViewCountWithAdultAdSuccessClicks	int
Metrics_LeftRailSuccessClickCount	int
Metrics_QueryViewCountWithLeftRailSuccessClicks	int
Metrics_ExploreSuccessClickCount	int
Metrics_QueryViewCountWithExploreSuccessClicks	int
ForayMetrics_HomepageFooter_ClickCount	int
Metrics_MOPEntityInlineQSSuccessClickCount	int
Metrics_QueryViewCountWithMOPEntityInlineQSSuccessClicks	int
Metrics_DCardWebIndexSiteSearchQuickBackClickCount	int
Metrics_BOPEntityInlineQSLastClickCount	int
Request_IsBot	boolean
Metrics_FooterQuickBackClickCount	int
Metrics_QueryViewCountWithRightPaneUpsellRegionClicks	int
Metrics_RightPaneUpsellRegionClickCount	int
Metrics_DCardAnswerClickCount	int
Metrics_QueryViewCountWithDCardAnswerClicks	int
Metrics_MOPEntityInlineQSLastClickCount	int
Metrics_QueryViewCountInPortraitMode	int
ForayMetrics_HomepageTBVideoTile_ClickCount	int
ForayMetrics_HomepageTaskBarVideosTile_DSQs	int
Metrics_QueryViewCountInSnapMode	int
Metrics_QueryViewCountWithRightPanePersonalizedDataEngagement	int
Metrics_QueryViewCountWithRightPanePersonalizedDataRealEngagement	int
Metrics_RightPanePersonalizedDataEngagementCount	int
Metrics_AdultAdQuickBackClickCount	int
Metrics_DCardAnswerQuickBackClickCount	int
Metrics_QueryViewCountWithExpertListRegionEngagement	int
Metrics_QueryViewCountWithRightPaneExpertListContainerRegionClick	int
Metrics_RightPaneExpertListContainerRegionClickCount	int
Metrics_RightPaneExpertListRegionClickCount	int
Metrics_RightPaneExpertListRegionEngagementCount	int
Metrics_WebIndexSuperFreshQuasiSFQuickBackClickCount	int
Metrics_QueryViewCountWithZoomOutRelatedRegionPresent	int
Metrics_DCardAnswerSuccessClickCount	int
Metrics_QueryViewCountWithDCardAnswerSuccessClicks	int
Metrics_QueryViewCountInSnapModeWithClicks	int
Metrics_CoreBottomCorrectionSuccessClickCount	int
Metrics_QueryViewCountWithCoreBottomCorrectionSuccessClicks	int
Metrics_QueryViewCountWithSearchHistorySuccessClicks	int
Metrics_SearchHistorySuccessClickCount	int
Metrics_QueryViewCountWithRelevantPeopleListRegionEngagement	int
Metrics_RightPaneRelevantPeopleListRegionEngagementCount	int
Metrics_QueryViewCountWithRightPaneTwitterTransferClicks	int
Metrics_RightPaneTwitterTransferClickCount	int
Metrics_DCardAnswerLastClickCount	int
Metrics_QueryViewCountWithTimeFilterClicks	int
Metrics_TimeFilterClickCount	int
Metrics_QueryViewCountWithRightPaneRelevantPeopleListContainerRegionClick	int
Metrics_RightPaneRelevantPeopleListContainerRegionClickCount	int
Metrics_RightPaneRelevantPeopleListRegionClickCount	int
Metrics_QueryViewCountWithZoomOutRelatedRegionClicks	int
Metrics_QueryViewCountWithDCardWebIndexPackageSearchClicks	int
Metrics_QueryViewCountWithRightPaneFacebookTransferClicks	int
Metrics_RightPaneFacebookTransferClickCount	int
Metrics_TOPEntityInlineQSLastClickCount	int
Metrics_IsPrivateMode	boolean
Metrics_SOFAPageFacebookContentClickCount	int
Metrics_QueryViewCountWithRightPaneCollapse	int
Metrics_RightPaneCollapseCount	int
Metrics_QueryViewCountInPortraitModeWithClicks	int
Metrics_QueryViewCountWithRightPaneExpand	int
Metrics_RightPaneExpandCount	int
Metrics_CorePaginationSuccessClickCount	int
Metrics_QueryViewCountWithCorePaginationSuccessClicks	int
Metrics_QueryViewCountWithRightPaneHover	int
Metrics_QueryViewCountWithRightPaneRelevantPeopleListRegionHover	int
Metrics_RightPaneHoverCount	int
Metrics_RightPaneRelevantPeopleListRegionHoverCount	int
Metrics_QueryViewCountWithRightPanePostControlRegionClicks	int
Metrics_RightPanePostControlRegionClickCount	int
Metrics_NavBarClickCount	int
Metrics_QueryViewCountWithNavBarClicks	int
Metrics_NavBarQuickBackClickCount	int
Metrics_AnswerBarClickCount	int
Metrics_QueryViewCountWithAnswerBarClicks	int
Metrics_QueryViewCountWithRightPaneSocialPost	int
Metrics_RightPaneSocialPostCount	int
Metrics_NavBarSuccessClickCount	int
Metrics_QueryViewCountWithNavBarSuccessClicks	int
Metrics_NavBarHeaderPageTitleClickCount	int
Metrics_QueryViewCountWithNavBarHeaderPageTitleClicks	int
Metrics_BingTogetherSharedQueryCount	int
Metrics_DCardWebIndexRelatedSiteLastClickCount	int
Metrics_ECardAnswerRowClickCount	int
Metrics_ECardAnswerRowItemCount	int
Metrics_ECardBlurbClickCount	int
Metrics_ECardBlurbItemCount	int
Metrics_ECardClickCount	int
Metrics_ECardDominantImageClickCount	int
Metrics_ECardDominantImageItemCount	int
Metrics_ECardFreshContentClickCount	int
Metrics_ECardFreshContentItemCount	int
Metrics_ECardItemCount	int
Metrics_FriendsPhotoUpsellItemCount	int
Metrics_HighMonetizationQuerySuggestionsClickCount	int
Metrics_HighMonetizationQuerySuggestionsItemCount	int
Metrics_HighMonetizationQuerySuggestionsLastClickCount	int
Metrics_HighMonetizationQuerySuggestionsQuickBackClickCount	int
Metrics_HighMonetizationQuerySuggestionsSuccessClickCount	int
Metrics_InputMethod	string
Metrics_MobileOperator	string
Metrics_PeopleDisambiguationClickCount	int
Metrics_PeopleDisambiguationItemCount	int
Metrics_QueryViewCountWithActivityListRegionEngagement	int
Metrics_QueryViewCountWithActivityListRegionPresent	int
Metrics_QueryViewCountWithBingTogetherSharedQuery	int
Metrics_QueryViewCountWithCompareClicks	int
Metrics_QueryViewCountWithComparePresent	int
Metrics_QueryViewCountWithECardAnswerRowClicks	int
Metrics_QueryViewCountWithECardAnswerRowPresent	int
Metrics_QueryViewCountWithECardBlurbClicks	int
Metrics_QueryViewCountWithECardBlurbPresent	int
Metrics_QueryViewCountWithECardClicks	int
Metrics_QueryViewCountWithECardDominantImageClicks	int
Metrics_QueryViewCountWithECardDominantImagePresent	int
Metrics_QueryViewCountWithECardFreshContentClicks	int
Metrics_QueryViewCountWithECardFreshContentPresent	int
Metrics_QueryViewCountWithECardFreshContentRssAnswerClicks	int
Metrics_QueryViewCountWithECardFreshContentRssAnswerPresent	int
Metrics_QueryViewCountWithECardPresent	int
Metrics_QueryViewCountWithEntityResultsEnhancedViewLinkClicks	int
Metrics_QueryViewCountWithEntityResultsEnhancedViewLinkPresent	int
Metrics_QueryViewCountWithEntityResultsSpamLinkClicks	int
Metrics_QueryViewCountWithEntityResultsSpamLinkPresent	int
Metrics_QueryViewCountWithFriendsPhotoUpsellPresent	int
Metrics_QueryViewCountWithHighMonetizationQuerySuggestionsClicks	int
Metrics_QueryViewCountWithHighMonetizationQuerySuggestionsPresent	int
Metrics_QueryViewCountWithHighMonetizationQuerySuggestionsSuccessClicks	int
Metrics_QueryViewCountWithInlineECardClicks	int
Metrics_QueryViewCountWithInlineECardPresent	int
Metrics_QueryViewCountWithPeopleDisambiguationClicks	int
Metrics_QueryViewCountWithPeopleDisambiguationPresent	int
Metrics_QueryViewCountWithPromoteIEClicks	int
Metrics_QueryViewCountWithPromoteIEPresent	int
Metrics_QueryViewCountWithRelatedQSCompareClicks	int
Metrics_QueryViewCountWithRelatedQSComparePresent	int
Metrics_QueryViewCountWithRelevantSearchHistoryClicks	int
Metrics_QueryViewCountWithRelevantSearchHistoryPresent	int
Metrics_QueryViewCountWithRightPaneActivityListContainerRegionClick	int
Metrics_QueryViewCountWithRightPaneActivityListRegionHover	int
Metrics_QueryViewCountWithRightPaneExpertListRegionHover	int
Metrics_QueryViewCountWithSetBingDefaultsClicks	int
Metrics_QueryViewCountWithSetBingDefaultsPresent	int
Metrics_QueryViewCountWithSetHomepageClicks	int
Metrics_QueryViewCountWithSetHomepagePresent	int
Metrics_QueryViewCountWithSetSearchEngineClicks	int
Metrics_QueryViewCountWithSetSearchEnginePresent	int
Metrics_QueryViewCountWithSharedQueryCommentActivity	int
Metrics_QueryViewCountWithSharedQueryCommentOrLikeActivity	int
Metrics_QueryViewCountWithSharedQueryLikeActivity	int
Metrics_QueryViewCountWithSocialPostCommentActivity	int
Metrics_QueryViewCountWithSocialPostCommentOrLikeActivity	int
Metrics_QueryViewCountWithSocialPostLikeActivity	int
Metrics_QueryViewCountWithTaskSharingClicks	int
Metrics_QueryViewCountWithTaskSharingPresent	int
Metrics_QueryViewCountWithTOCClicks	int
Metrics_QueryViewCountWithTOCPresent	int
Metrics_QueryViewCountWithTOCSuccessClicks	int
Metrics_QueryViewCountWithTOCTOCAlgorithmicClicks	int
Metrics_QueryViewCountWithTOCTOCAlgorithmicPresent	int
Metrics_QueryViewCountWithTOCTOCEditorialClicks	int
Metrics_QueryViewCountWithTOCTOCEditorialPresent	int
Metrics_QueryViewCountWithTOCVerticalNavClicks	int
Metrics_QueryViewCountWithTOCVerticalNavPresent	int
Metrics_QueryViewCountWithTOCVerticalNavSuccessClicks	int
Metrics_QueryViewCountWithTOCWebGroupClicks	int
Metrics_QueryViewCountWithTOCWebGroupPresent	int
Metrics_QueryViewCountWithTOCWebGroupSuccessClicks	int
Metrics_QueryViewCountWithTopECardClicks	int
Metrics_QueryViewCountWithTopECardPresent	int
Metrics_RelatedQSCompareLastClickCount	int
Metrics_RelevantSearchHistoryClickCount	int
Metrics_RelevantSearchHistoryItemCount	int
Metrics_RightPaneActivityListContainerRegionClickCount	int
Metrics_RightPaneActivityListRegionClickCount	int
Metrics_RightPaneActivityListRegionEngagementCount	int
Metrics_RightPaneActivityListRegionHoverCount	int
Metrics_RightPaneActivityListRegionItemCount	int
Metrics_RightPaneExpertListRegionHoverCount	int
Metrics_RightPaneSharedQueryCommentCount	int
Metrics_RightPaneSharedQueryCommentOrLikeCount	int
Metrics_RightPaneSharedQueryLikeCount	int
Metrics_RightPaneSocialPostCommentCount	int
Metrics_RightPaneSocialPostCommentOrLikeCount	int
Metrics_RightPaneSocialPostLikeCount	int
Metrics_TaskSharingClickCount	int
Metrics_TaskSharingItemCount	int
Metrics_TOCClickCount	int
Metrics_TOCItemCount	int
Metrics_TOCQuickBackClickCount	int
Metrics_TOCSuccessClickCount	int
Metrics_TOCVerticalNavClickCount	int
Metrics_TOCVerticalNavItemCount	int
Metrics_TOCVerticalNavQuickBackClickCount	int
Metrics_TOCVerticalNavSuccessClickCount	int
Metrics_TOCWebGroupClickCount	int
Metrics_TOCWebGroupItemCount	int
Metrics_TOCWebGroupQuickBackClickCount	int
Metrics_TOCWebGroupSuccessClickCount	int
Request_IsBotVNext	boolean
ForayMetrics_HomepageProgramBar_DSQs	int
ForayMetrics_HomepageTaskBarWeatherTile_DSQs	int
ForayMetrics_HomepageTBMovieTile_ClickCount	int
ForayMetrics_HomepageTBMovieTile_ItemCount	int
ForayMetrics_HomepageTBNewsTile_ClickCount	int
ForayMetrics_HomepageTBNewsTile_ItemCount	int
ForayMetrics_HomepageTBTrafficTile_ClickCount	int
ForayMetrics_HomepageTBTrafficTile_ItemCount	int
ForayMetrics_HomepageTBWeatherTile_ClickCount	int
ForayMetrics_HomepageTBWeatherTile_ItemCount	int
